#DoNotComply	mid
#donotcomply    mid
#NoVaccinePassports	mid
#GetVaccinated	pro
#getvaccinated  pro
#NoVaccineMandates	mid
#VaccinesWork	pro
#antivaxxers	anti
#NoVaccinePassportsAnywhere	mid
#Fauci	anti
#NoGreenPass	mid
#VaccineSideEffects	mid
#Plandemic	anti
#plandemic  anti
#WearAMask	pro
#VaccinePassports	mid
#VaccinesSaveLives	pro
#COVIDIOTS	mid
#MyBodMyChoice	mid
#HoldTheLine
#Freedom	mid
#Scamdemic	anti
#GetVaxxed	pro
#CovidVaccine	mid
#NoVaccinePassport	mid
#antivax	anti
#VaccineMandate	mid
#vaccinated	pro
#resist	anti
#NoVacci	anti
#SayNoToTheJab	anti
#vaccination	pro
#NoVaccineMandate	mid
#NoVaccin	anti
#NoVaccine	anti
#VaccineMandates	mid
#NoMoreLockdowns	mid
#NoMedicalApartheid	mid
#Unvaccinated	mid
#MedicalApartheid	mid
#GetVaccinatedNow	pro
#Lockdown	mid
#JustSayNo	anti
#WakeUp	anti
#NoVaccinePassportAnywhere	mid
#Covididiots	mid
#VaccinePassport	mid
#NoVaccinem	mid
#NoVaccinePas	mid
#Mask	pro
#ArrestFauci	pro
#NoMandates	mid
#novaccinemandates  mid
#NoVaccinePassp	mid
#NoVacc	anti
#NoMandatoryVaccines    mid
#CovidVaxExposed    anti

