@BernieSpofforth	mid
@JamesMelville	mid
@EssexPR	mid
@alanvibe	mid
@GillianMcKeith	mid
@jackjohnsoniv7	pro
@RealCandaceO	mid
@org_scp	mid
@BananaMediaQ	mid
@Togetherdec	mid
@JamesfWells	anti
@LozzaFox	mid
@djlange	mid
@kernaghanscott5	anti
@EU_Commission	pro
@TonyHinton2016	mid
@ToniaBuxton	mid
@PeterDooleyDUB	mid
@CTZebra	pro
@atensnut	mid
@greenhousemd   pro
@HumanRights4UK mid